



                                                                                                                          
  ..##..................##..................##..........##..................##..............##......##..................  
  ..######..##..######..##############..##..##..######..##..######..######..######..######..##..######..##############..  
  ......##..##..##......##......##......##......##......##..##......##......##......##......##..........##..##..........  
  ####..######..##..######..##..##..##############..######..##..######..######..######..######..##########..##..######..  
  ..##..........##......##..##......##..##......##..##......##..##..##......##..##..##......##..........##..##......##..  
  ..##################..##..##########..##..##..##..##..######..##..######..##..##..######..##########..##..######..####  
  ..........##......##..##..##......##......##..##..##......##..##......##......##......##..##..##......##......##......  
  ####..##..######..##..##..##..##..######..##..##..##########..##..##############..######..##..##..##########..######..  
  ......##..........##..##......##......##..##......##..........##..................##......##..##..##......##......##..  
  ..######..##########..##############..##..##########..##########..######..##########..######..##..##..##..##..######..  
  ..##......##..........##..............##..##..........##......##......##..........##..##......##..##..##......##......  
  ..##########..##########..##############..##..##########..##########..##########..##..##..##..##..##..##########..##..  
  ..........##..##..............##......##......##..................##..##......##......##..##..........##..........##..  
  ..######..##..##..##########..##..##..##############..######..######..##..##..######################..##..##########..  
  ..##..##......##..##......##..##..##..............##......##..##......##..##..##..............##......##..##......##..  
  ..##..##########..##..##..##..##..##############..##########..##..######..######..######..##..##..######..##..##..##..  
  ..##......##......##..##..##..##......##......##..........##......##..................##..##..##..##......##..##..##..  
  ..##..##..##..######..##..##..######..##..##..##########..######..##..##################..##..######..######..##..##..  
  ..##..##..##......##..##..##......##......##..##......##......##..##......##......##......##......##..##......##..##..  
  ..##..##..##########..##..##..##..##########..##..##..######..##..##########..##..##..##########..##..##..######..##..  
  ......##..............##..##..##......##......##..##..##..##..##..............##..##......##......##......##......##..  
  ########################..##..##..##..##..######..##..##..##..##################..######..##..######..##..##..######..  
  ..........##......##......##..##..##..##..##......##......##......##......##..##..##......##..##......##..##......##..  
  ..##..######..##..##..######..##..######..######..######..######..##..##..##..##..##..######..######..##########..##..  
  ..##..........##..##..##......##......##......##......##......##..##..##..##..##......##..........##..##..........##..  
  ..##############..##..##..##########..######..######..##########..##..##..##..##################..######..##########..  
  ......##......##..##..##..##......##......##......##..##..........##..##..........##..........##......##..##......##..  
  ####..##..######..##..######..##..######..######..##..##..##########..##########..######..##..######..##..##..##..##..  
  ......##..##......##..........##......##..........##..##..##......##..........##..........##......##......##..##......  
  ..######..##..##..##################..##..##########..##..######..##..######..##########..##################..########  
  ......##..##..##......##..............##..##..........##..##......##..##..##......##..##..##..............##......##..  
  ####..##..##..##########..##############..##..##########..##..######..##..######..##..##..##..##########..######..##..  
  ..##......##..........##..........##......##..##..........##......##......##......##......##..........##......##......  
  ..######..##########..##########..##..######..##..##########..##..##..######..######..##############..##..##########..  
  ..................##......##......##......##..##..##..........##......##......##..##..##..........##..##..............  
  ..##################..######..##########..##..##..##########..##########..######..##..##..##..##..##..################  
  ......##..##..........##......##..........##..##..##......##..##..........##..........##..##..##..##......##......##..  
  ####..##..##..##########..######..##########..##..##..##..######..##################..##..##..##########..##..##..##..  
  ..........##..##..........##..##..##..........##......##..##......##..............##..##..##..............##..##......  
  ############..##..##########..##..##########..##########..##..######..##########..######..##################..######..  
  ..........##..##..##......##......##..................##..##..............##......##......##......##..........##..##..  
  ..######..##..##..##..##..##..######..##############..##..##################..##..##..######..##..##..##########..##..  
  ......##..##..##..##..##..##..##......##..........##..##..............##......##..##..##......##......##..........##..  
  ####..##..##..##..##..######..##..##..##..######..##..##############..##..##########..##..##############..##########..  
  ......##......##..##..##......##..##..##..##..##..##......##..........##..............##..##..............##..........  
  ..##############..##..##..##########..##..##..##..######..##..##########..##############..##..######..##..##..########  
  ..........##......##..##..............##..##......##..##..##..##..........##..##..........##......##..##..##..##......  
  ..######..##..######..##############..##..##..######..##..##..##..##########..##..######..##..######..##..##..######..  
  ..##..##..##......##..............##..##..##......##......##..##..........##..##..##......##..##......##..##..##......  
  ..##..##..######..##..##..##########..##..######..##########..##########..##..##..##..######..##..##..######..##..##..  
  ..##..##......##..##..##..........##..##..##..............##..##..........##......##..##......##..##..##......##..##..  
  ..##..######..##..##############..##..##..##############..##..##########..##########..##..######..##..##..######..####  
  ..........##..##..............##......##..........##..##..##..........##..............##......##..##..##......##......  
  ########..##..##############..##############..##..##..##..##..######..##########################..##..######..######..  
  ..##......##..............##..............##..##..##......##......##..##..........##..............##......##..........  
  ..##..##############..##################..######..##..##############..##..##..######..##..##############..##########..  
  ......##..........##..........##......##......##..##......##......##..##..##......##..##..............##......##......  
  ..##########..##..##########..##..##..######..##..######..##..##..##..##..######..##..##############..##########..####  
  ..............##..........##......##..............##..........##......##......##..................##..................  
                                                                                                                          
